EEEEEEEEEEEEEEEEEEEEEEEEEEEEEEEEEEEEEEEEEEEEEEEEEEEEEEEEEEEEEEEEEEEEEEEEEEEEEEEEEEEEEEEEEEEEEEEEEEEE
EEEEEEEEEEEEEEEEEEEEEEEEEEEEEEEEEEEEEEEEEEEEEEEEEEEEEEEEEEEEEEEEEEEEEEEEEEEEEEEEEEEEEEEEEEEEEEEEEEEE
EEEEEEEEEEEEEEEEEEEEEEEEEEEEEEEEEEEEEEEEEEEEEEEEEEEEEEEEEEEEEEEEEEEEEEEEEEEEEEEEEEEEEEEEEEEEEEEEEEEE
EEEEEEEEEEEEEEEEEEEEEEEEEEEEEEEEEEEEEEEEEEEEEEEEEEEEEEEEEEEEEEEEEEEEEEEEEEEEEEEEEEEEEEEEEEEEEEEEEEEE
EEEEEEEEEEEEEEEEEEEEEEEEEEEEEEEEEEEEEEEEEEEEEEEEEEEEEEEEEEEEEEEEEEEEEEEEEEEEEEEEEEEEEEEEEEEEEEEEEEEE
EEEEEEEEEEEEEEEEEEEEEEEEEEEEEEEEEEEEEEEEEEEEEEEEEEEEEEEEEEEEEEEEEEEEEEEEEEEEEEEEEEEEEEEEEEEEEEEEEEEE
EEEEEEEEEEEEEEEEEEEEEEEEEEEEE         EEE          VVV             VV                               
EEEEEEEEEVVVVVVVVVUVVVVVVVVVV         EEE            VUVVVVVVVVVVVVUVVVVV                           
EEEEEEEEEEVVVVVVVVVVVVVVVVVVV         EEE            VVVVVVVVVVV      VVVVV                         
EEEEEEEEVVVVVVVVVVVVVVVVVVVVVV         EEE          VVVVVVVVVVVV       VVV                          
EEEEEEEEEEEUVVVVVVVVVVVVVVVVVVUVVVV    EEEEEEEEEEEEEVVVVVVVVVVVVVVVVVVVVVVV                         
EEEEEEEEEEEVVVVVVVVVVVVVVVUVVVVVVVV  EEE          EEEEE          VUVVVVVVVVUVVVVVV                  
EEEEEEEEEEEVVVVVVVVVVVVVVVVVVVVVVVVVVEEE          EEEEE         VVVVVVVVVVVVVV                      
EEEEEEEEEEVVVVVVVVVVVVVVVVVVVVVVVVVVEEE           EEEEEVVVVVVVVVVVVVVVVVVVVVVVVVVVVVUVV             
EEEEEEEEVVVVVVVVVVVUVVVVVVVVVVVVVVVVEEE           EEEEEVVVVVVVVVVVVVVVVVVVVVVVVVVVVVVVV             
EEEEEEEEEEVVVVVVVVVVVVVVVVVVVVVVVVVVEEE           EEEEE                                             
                                    EEE             EEE                                             
                                   EEE               EEE                                            
                                   EEE                EEEEEEEEEEEEEEEEEEEEEEEEEEEEEEEEEEEEEEEEEEEEEE
                                  EEE                  EEEEEEEEEEEEEEEEEEEEEEEEEEEEEEEEEEEEEEEEEEEEE
                                 EEE                   EEEEEEEEEEEEEEEEEEEEEEEEEEEEEEEEEEEEEEEEEEEEE
                                EEE                     EEE                                         
                VVVVVVVVVVVVVVEEEVVVVVVVVVVVVVVV         EEE                                        
              VVVVVVVVVVVVVVVEEEVVVVVVUVVVVVVVVVVV        EEE                    VVVVVVVVVVVVVV     
           VVVVVUVVVVVVVVVVVVEEEVVVVVVVVVVVVVVVUV          EEE                  VVVVVVVVVUVVVVVVVV  
              VVVVVVVVVVVVVVVVEEEVVVVVVVVVVVVVVVV           EEE                VVVVVVVVVVVVVVVVV    
               VVVVVVVVVVVVVEEEUVVVVVVVVVVVVVVVV             EEE                  VVVUVVVVVVVV      
              VVVVVVVVVVVVVEEEVVVVVVVVVVVVVVVVVVV             EEE               VVVVVVVVVVVVVVVVV   
            VVVVVVVVUVVVVVEEEVVVVVVVVVVVVVVVVV                EEE              VVVVVVVVVVVVVVVVV    
             VVVVVVVVVVVVEEEVVVVVVVVVVVVVVVVVVVVVV            EEE                 VVVVVVVVUVVV      
            VVUVVVVVVVVVVEEEVVVVVVVVVVVUVVVVVVVVV             EEE                VVVVVVVVVVVVVVVV   
               VVVVVVVVVVEEEVVVVVVVVVVVVVVVVVVV                EEE              VVVUVVVVVVVVVVV     
             VVVVVVVUVVVVEEEVVVUVVVVVVVVVVVVVVVVV               EEE            VVVVVVVVVVVVUVVVVVV  
            VVVVVVVVVVVVVEEEVVVVVVVVVVVVVVVVVUVVVV              EEE              VVVVVVVVVVVVVVV    
               VVVVVVVVVVEEEVVVVVVVVVVVVVVVVVVVV                EEE                                 
                         EEE                                    EEE                                 
                         EEE                                    EEE                                 
                         EEE                                    EEE                                 
                         EEE                                    EEE                                 
                         EEE                                    EEE                                 
