EEEEEEEEEEEEEEEEEEEEEEEEEEEEEEEEEEEEEEEEEEEEEEEEEEEEEEEEEEEEEEEEEEEEEEEEEEEEEEEEEEEEEEEEEEEEEEEEEEEE
EEEEEEEEEEEEEEEEEEEEEEEEEEEEEEEEEEEEEEEEEEEEEEEEEEEEEEEEEEEEEEEEEEEEEEEEEEEEEEEEEEEEEEEEEEEEEEEEEEEE
EEEEEEEEEEEEEEEEEEEEEEEEEEEEEEEEEEEEEEEEEEEEEEEEEEEEEEEEEEEEEEEEEEEEEEEEEEEEEEEEEEEEEEEEEEEEEEEEEEEE
EEEEEEEEEEEEEEEEEEEEEEEEEEEEEEEEEEEEEEEEEEEEEEEEEEEEEEEEEEEEEEEEEEEEEEEEEEEEEEEEEEEEEEEEEEEEEEEEEEEE
EEEEEEEEEEEEEEEEEEEEEEEEEEEEEEEEEEEEEEEEEEEEEEEEEEEEEEEEEEEEEEEEEEEEEEEEEEEEEEEEEEEEEEEEEEEEEEEEEEEE
EEEEEEEEEEEEEEEEEEEEEEEEEEEEEEEEEEEEEEEEEEEEEEEEEEEEEEEEEEEEEEEEEEEEEEEEEEEEEEEEEEEEEEEEEEEEEEEEEEEE
EEEEEEEEEEEEEEEEEEEEEEEEEEEEE         EEE          VVV             VV                               
EEEEEEEEEVVVVVVVVVUVVVVVVVVVV         EEE            VUVVVVVVVVVVVVUVVVVV                           
EEEEEEEEEEVVVVVVVVVVVVVVVVVVV         EEE            VVVVVVVVVVV      VVVVV                         
EEEEEEEEVVVVVVVVVVVVVVVVVVVVVV         EEE          VVVVVVVVVVVV       VVV                          
EEEEEEEEEEEUVVVVVVVVVVVVVVVVVVUVVVV    EEEEEEEEEEEEEVVVVVVVVVVVVVVVVVVVVVVV                         
EEEEEEEEEEEVVVVVVVVVVVVVVVUVVVVVVVV  EEE          EEEEE          VUVVVVVVVVUVVVVVV                  
EEEEEEEEEEEVVVVVVVVVVVVVVVVVVVVVVVVVVEEE          EEEEE         VVVVVVVVVVVVVV                      
EEEEEEEEEEVVVVVVVVVVVVVVVVVVVVVVVVVVEEE           EEEEEVVVVVVVVVVVVVVVVVVVVVVVVVVVVVUVV             
EEEEEEEEVVVVVVVVVVVUVVVVVVVVVVVVVVVVEEE           EEEEEVVVVVVVVVVVVVVVVVVVVVVVVVVVVVVVV             
EEEEEEEEEEVVVVVVVVVVVVVVVVVVVVVVVVVVEEE           EEEEE                                             
                                    EEE             EEE                                             
                                   EEE               EEE                                            
                                   EEE                EEEEEEEEEEEEEEEEEEEEEEEEEEEEEEEEEEEEEEEEEEEEEE
                                  EEE                  EEEEEEEEEEEEEEEEEEEEEEEEEEEEEEEEEEEEEEEEEEEEE
                                 EEE                   EEEEEEEEEEEEEEEEEEEEEEEEEEEEEEEEEEEEEEEEEEEEE
                                EEE                     EEE                                         
                VVVVVVVVVVVVVVEEE                        EEE                                        
              VVVVVVVVVVVVVVVEEE                          EEE                    VVVVVVVVVVVVVV     
           VVVVVUVVVVVVVVVVVVEEE                           EEE                  VVVVVVVVVUVVVVVVVV  
              VVVVVVVVVVVVVVVVEEE                           EEE                VVVVVVVVVVVVVVVVV    
               VVVVVVVVVVVVVEEE            V V               EEE                  VVVUVVVVVVVV      
              VVVVVVVVVVVVVEEE           VVVVVV               EEE               VVVVVVVVVVVVVVVVV   
            VVVVVVVVUVVVVVEEE           VVVVVVVV              EEE              VVVVVVVVVVVVVVVVV    
             VVVVVVVVVVVVEEE           VV  V V VV             EEE                 VVVVVVVVUVVV      
            VVUVVVVVVVVVVEEE           VV  V V                EEE                VVVVVVVVVVVVVVVV   
               VVVVVVVVVVEEE           VV  V V                 EEE              VVVUVVVVVVVVVVV     
             VVVVVVVUVVVVEEE           VV  V V                  EEE            VVVVVVVVVVVVUVVVVVV  
            VVVVVVVVVVVVVEEE            VVVVVVV                 EEE              VVVVVVVVVVVVVVV    
               VVVVVVVVVVEEE             VVVVVVV                EEE                                 
                         EEE               V V VV               EEE                                 
                         EEE           VV  V V VV               EEE                                 
                         EEE           VVVVVVVVV                EEE                                 
                         EEE            VVVVVVV                 EEE                                 
                         EEE               V V                  EEE                                 