EEEEEEEEEEEEEEEEEEEEEEEEEEEEEEEEEEEEEEEEEEEEEEEEEEEEEEEEEEEEEEEEEEEEEEEEEEEEEEEEEEEEEEEEEEEEEEEEEEEEEEEEEEEEEEEEEEEEEEEEEEEEE
EEEEEEEEEEEEEEEEEEEEEEEEEEEEEEEEEEEEEEEEEEEEEEEEEEEEEEEEEEEEEEEEEEEEEEEEEEEEEEEEEEEEEEEEEEEEEEEEEEEEEEEEEEEEEEEEEEEEEEEEEEEEE
EEEEEEEEEEEEEEEEEEEEEEEEEEEEEEEEEEEEEEEEEEEEEEEEEEEEEEEEEEEEEEEEEEEEEEEEEEEEEEEEEEEEEEEEEEEEEEEEEEEEEEEEEEEEEEEEEEEEEEEEEEEEE
EEEEEEEEEEEEEEEEEEEEEEEEEEEEEEEEEEEEEEEEEEEEEEEEEEEEEEEEEEEEEEEEEEEEEEEEEEEEEEEEEEEEEEEEEEEEEEEEEEEEEEEEEEEEEEEEEEEEEEEEEEEEE
EEEEEEEEEEEEEVEEEEEEEEEEEEEEEEEEEEEEEEEEEEEEEEEEEEEEEEEEEEEEEEEEEEEEEEEEEEEEEEEEEEEEEEEEEEEEEEEEEEEEEEEEEEEEEEEEEEEEEEEEEEEEE
EEEEEEEEEEEVVEEEEEEEEVEEEEEEEEEEEEEEEEEEEEEEEEEEEEEEEEEEEEEEEEEEEEEEEEEEEEEEEEEEEEEEEEEEEEEEEEEEEEEEEEEEEEEEEEEEEEEEEEEEEEEEE
EEEEEEEEEEVVVEEEEEEEVVEEEEEE         EEE          VVV             V                                                          
EEEEEEEEVVVVVVVVVUVVVVVVVVVV         EEE            VUVVVVVVVVVVVVUVVVVV                                                     
EEEEEEEEEVVVVVVVVVVVVVVVVVVV         EEE            VV               VVVVV                                                   
EEEEEEEVVVVVVVVVVVVVVVVVVVVVV         EEE          VVVVVVVVVVVV       VVV                                                    
EEEEEEEEEEUVVVVVVVVVVVVVVVVVVUVVVV    EEEEEEEEEEEEE          VVVVVVUVVVVVV                                                   
EEEEEEEEEEVVVVVVVVVVVVVVVUVVVVVVVV  EEE          EEEEE          VUVVVVVVVVVVVVVVV                                            
EEEEEEEEEEVVVVVVVVVVVVVVVVVVVVVVVVVVVEE          EEEEEEE       VVVVVVVVVVVVVV                                                
EEEEEEEEEVVVVVVVVVVVVVVVVVVVVVVVVVVVVVVVVVVVVVVVVVVVVVVVVVVVVVVVVVVVVVVVVVVVVVVVVVVUVV                                       
EEEEEEEVVVVVVVVVVVUVVVVVVVVVVVVVVVVVEE           EEEEE                                                                       
EEEEEEEEEVVVVVVVVVVVVVVVVVVVVVVVVVVVEE           EEEEE                                                                       
EEEEEEEEEEEEEVVEEEEEEEEEEEEEEEEEEVVEEEEEEEEEEEEEEEEEEEEEEEEEEEEEEEEEEEEEEEEEEEEEEEEEEEEEEEEEEEEEEEEEEEEEEEEEEEEEEEEEEEEEEEEEE
                                 VV                                    V        EEEEEEEEEEEEEEEEEEEEEEEEEEEEEEEEEEEEEEEEEEEEE
                                 VV                             EEE    VV       EEEEEEEEEEEEEEEEVVVVVVVVVEEEEEEEEEEEEEEEEEEEE
                                          VV                  EE                 V       EEEEEEEEEEEEVVVVUVVVVVVVVVVVEEEEEEEE
     V V               EE            VV                                    VV       EEEEEEEEEEVVVVVVVEEEVVVVVVUVEEEEEEEEEEEEE
     V V                           VV                                VVVVVVV     EEEEEEEEEVVEVVVVEEEEVVVVVVVVEEEEEEEEEEEEEEEE
   VVVVVV            VVVVVV  VVVVVVVVVVVVVVVVVVVV                 VVVUVV       EEEEEEEEVVEEEEVVVVEEEVVVVEEVEEEEEEEEEEEEEEEEE
  VVVVVVVV           VVVVVVVVVVVVVVVVUVVVVVVVVV      VV      V VVVVVV           EEEEEEEVVEEEVVVUVVVVVVEEEEEEEEEEEEEEEEEEEEEEE
 VV  V V VV     VVVVVVVVVVVVVVVVVVVVVVVVVVVVVVVVVVVVVVVVVVVVVVVVVVVVVVVVVVVVVVVVVVVVVVVVEEEEEEEEEEEEEEEEEEEEEEEEEEEEEEEEEEEEE
 VV  V V VV     VVVVVVUVVVVVVVVVEEEVVVVVVVVEEEEVVVVVVV   VVVUVVVVVVVV           EEEEEEEEEEEEEEEEEEEEEEEEEEEEEEEEEEEEEEEEEEEEE
 VV  V V VV    VVVVVVVVVVVVVVVVVVVVVVVVVVEEEEEEVV                VVVVVVVV       EEEEEEEEEEEEEEEEEEEEEEEEEEEEEEEEEEEEEEEEEEEEE
 VV  V V          VVVVVVEEEEVVVVVVVVVVVVVVVVVVVVVVV          EEEEEVVVUVVVVV     EEEEEEEEEEEEEEEEEEEEEEEEEEEEEEEEEEEEEEEEEEEEE
  VVVVVVV       VVVVVVVVVVVVVEEEEVVVVUVVVVVVVVVV        EEEEEEEEEEEEEEEEEEEEEEEEEEEEEEEEEEEEEEEEEEEEEEEEEEEEEEEEEEEEEEEEEEEEE
   VVVVVVV      V    VVVVVVVVVVVVVVVVVV      VVV          EEEEEE                EEEEEEEEEEEEEEEEEEEEEEEEEEEEEEEEEEEEEEEEEEEEE
     V V VV                                                                                                                  
 VV  V V VV                                                                                                                  
 VVVVVVVVV                                                                                                                   
  VVVVVVV                                                                                                                    
     V V                                                                                                                     
     V V                                                                                                                     