                                                                                
                                                                                
EEEEEEEEEEEEE                                                                   
EEEEEEEEEEEEE                                                                   
EEEEEEEEEEEEE                                                                   
EEEEEEEEEEEEE                                                           EEEEEEEE
                                                                        EEEEEEEE
                        VVVVVVVVVV                                              
                        VVVVVUVVVV                                              
                        UVVVVVVUVV                                              
                        VVVVVVVVVV                                              